11111111111111111111111111
1P0000000111000000T0000001
10111110001000111101111101
10000000000000000000000C01
10111101111101111101111001
1000000T000100000000000001
10111111101011111011111101
1000000000000000T000000001
10111101111101111101111001
100000000000000000000000E1
11111111111111111111111111
