111111111111111111111111111
1P0000000T00000000000C00011
100011110000000T00111000001
1000T000000111000000000T001
100000001000001000000000001
10C0000000000T00000000000E1
100000000011111100000000001
1000T0000000000000T00000001
100000001000001000000111001
1000000000T000000000C000001
111111111111111111111111111
