111111111111111111111111111
100000000T000000P0000000001
1C00000000000000000000000E1
100000T000000000000T0000001
10T0000000000000000000000T1
100000000000000000000000001
100000000000000000000000001
100000000000000000000000001
1E00000000000000000000000C1
100000000P0000000T000000001
111111111111111111111111111