11111111111111111111111111
1P000000000111100000000001
10111101111010011110111101
10C000010000100000100000C1
11101111011110111110111011
10001000010000000C00100001
10111011110111111011101101
100000100T00T0000001000001
10111110111101111110111101
10T000000C00000000000000E1
11111111111111111111111111
