1111111111
1000001011
1110000001
1C00P00E11
1111111111