111111111111111111111111111
1P0000000111110000000000001
101111110100001011111111101
10C0000010000010000000000C1
111011111011111110111110111
100010000010000000000001001
101110111111011111111101101
10000010000C000000001000001
101111101111011111101111101
1C00000000000011100000000E1
111111111111111111111111111
