111111111111111
1ET000T000C0001
1111P000T0000C1
100000T11111111
1100000T0000C11
111111111111111