111111111111111
1ET00T000C00011
111100P000000C1
100000T11111111
11000P00000C111
111111111111111111